10 12 2
16 15 15 15 15 15 15 15 15 17
14 0  0  0  0  0  0  0  0  14
14 0  0  0  0  0  0  0  0  14
14 0  0  0  0  0  0  0  0  14
14 0  0  0  1  0  0  0  0  14
14 0  0  0  0  0  0  0  0  14
14 0  0  0  0  0  0  0  0  14
14 0  0  0  5  0  0  0  0  14
14 0  0  0  0  0  0  0  0  14
14 0  0  0  0  0  0  0  0  14
14 0  0  0  0  0  0  0  0  14
18 15 15 15 15 15 15 15 15 19